#########
###....##
###.##.##
###..#.##
######.##
##.....##
##.#.####
####.####