#########
###....##
###.##.##
#.#..#.##
#.####.##
##.....##
##.#.##.#
####.####